purple relieve blue be black doubt => believe
blue bye blue bite white two-sided => bilateral
purple ground red boundless white leap => bound

blue cough blue on white noise => cacophony
red century purple failure brown offenses => censure
purple environmental purple confidential black causal => coincidental
purple mercy purple contrabands purple discussion => controversy

magenta proffesionals blue on red language => jargon
blue on blue dice black tan => jaundice
magenta bell blue in white ditty => jingle
blue jock purple binocular white hilarious => jocular

red grayscale red likeableness magenta green => kale
purple steal red glockenspiel red ship => keel
blue wee magenta noun magenta fruit => kiwi
blue leapt blue man black extravagance => kleptomania

blue sir purple occupation brown knife => laceration
red largest blue large white generosity => largesse
blue attitude yellow altitude black longitude => latitude
blue shun blue ill black massive => lilliputian

purple blasphemous mint orange white altruistic => magnanimous
purple primate mint mint white tycoon => magnate
purple pathetic mint purple white enchanting => magnetic
purple luminescent mint brown white majestic => magnificent

red catalytic red qualitative magenta shrub => qat
blue ant purple momentum red physics => quantum
purple glory purple starry white excavate => quarry
blue turn blue ten white fourth => quaternary

purple damage purple damage white damage => ravage
blue wreck purple accuse white disqualify => recuse
blue lies purple hypnotize white repair => revitalize
blue ugh red shrugged black soft => rugged

blue ick blue on black straightforward => sardonic
blue said purple complementary magenta rock => sedimentary
red skeleton yellow kins lavender human => skin
blue lime gray this black angsty => sublime

white tracked red contract black land => tract
lime grunt purple gigabyte magenta person => troglodyte
blue tell blue age black lecture => tutelage
blue tear purple uncanny brown leadership => tyranny

purple witness blue quit black nowhere => ubiquitous
blue tear purple superior black open => ulterior
blue knee blue can black ordinary => uncanny
blue tear purple contrarian white practical => utilitarian

blue aunt purple brilliant white wanderer => vagrant
blue very blue able black constant => variable
blue loss blue city blue speed => velocity
blue techs blue ere white intersection => vertex

blue rust mint  magenta desire => wanderlust
white whacks purple lax white rise => wax
blue war blue war white dock => wharf
blue wheel red wheatfield black drop => wield

blue know blue lit lavender rock => xenolith
blue foe blue no magenta person => xenophobe
purple phylum blue ye red plant => xylem
blue low blue lop blue key => xylophone

red cognac red yardstick magenta animal => yak
blue yell purple help white cry => yelp
blue oak purple nickel black you => yokel
blue you blue ide magenta season => yuletide

blue tree blue lot black indifference => zealotry
purple behemoth magenta zenith white maximum => zenith
blue fur magenta noun magenta air => zephyr
red tipsiest red zaniest white vigor => zest