red prosecute red charcuterie white intense => acute
blue ants blue flu brown investments => affluence
blue uh purple hoof black warm => aloof
blue meal blue ate black worsen => ameliorate

blue um yellow blamed white confusion => bedlam
blue lick blue bee black peaceful => bellicose
blue eight blue fur white bisected => bifurcated
purple route red whereabouts brown contamination => bout

blue air blue cat white cartoon => charicature
white seed red antecedent black keep => cede
purple kayak purple fantastical white fantastical => chimerical
purple bonnet blue me blue company => conglomerate

purple valley red sinusoidally black hurry => dally
purple inexperience blue let white harmful => deleterious
blue delusion blue is brown founding => dissolution
blue diss blue top black utopia => dystopia

purple encase blue a brown draw => efface
blue egg purple oblivious white horrible => egregious
blue mitt yellow time black contain => emit
blue we blue i black excitement => ennui

red facilitation red facetiously red problem => facet
blue stir blue us blue word => filibuster
yellow surface purple fissile white crack => fissure
yellow trough blue a black easy => fraught

blue air blue i white gaudy => garish
blue genie purple denial black rude => genial
blue glee yellow angle white collect => glean
blue oar red gorgeous brown river => gorge

blue yule blue he black easy => herculean
purple aesthetic blue he black cracked => hermetic
blue genius blue he black homogeneous => heterogeneous
yellow gin blue i red door => hinge

blue class blue con white rebel => iconoclast
purple sediment blue imp white hindrance => impediment
purple explain blue a black pragmatic => inane
purple encourageable blue rig black reformed => incorrigible

blue ill purple largess black vivacious => listless
blue lieu red elucidation white obvious => lucid
blue lieu blue crate white worthwhile => lucrative
yellow curl blue ur white stakeout => lurk

blue neigh blue sent black antiquated => nascent
blue clay blue men blue word => nomenclature
purple adjust blue plus black concerned => nonplussed
blue null blue no red shelf => novel

blue skate purple truncate black clarify => obfuscate
red obtrusive purple blouse black acute => obtuse
blue all blue nit red zoo => ornithologist
yellow taos red jousting black elect => oust

blue dime blue pad white example => paradigm
blue loot blue racy brown-black aristocracy => plutocracy
blue care blue car black safe => precarious
blue rose blue sac white dull => prosaic

blue wrack purple saboteur blue mouth => raconteur
blue sit blue ant black accomodating => recalcitrant
blue read yellow dresser white correction => redress
blue purr blue ire blue skill => repertoire

blue his red masochism black convergence => schism
blue toe red stomatics brown judicious => stoic
purple petrify blue up brown alcohol => stupefy
blue pull blue up white flexible => supple

blue purr purple entrainment white mood => temperament
purple sensitive blue ate black confident => tentative
blue oar yellow roost red body => torso
blue tree blue is blue word => treatise